Nicole,5,in,office_in,41,7915,12916,5001,0,8689,8689,7915,4227
Nicole,5,in,office_in,42,2758,7898,5140,0,5970,5970,2758,1928
Nicole,5,in,office_in,43,3073,8410,5337,0,7459,7459,3073,951
Nicole,5,in,office_in,44,2628,7762,5134,0,6674,6674,2628,1088
Nicole,5,in,office_in,45,9145,14859,5714,0,13073,13073,9145,1786
Nicole,5,in,office_in,46,2395,7394,4999,0,6441,6441,2395,953
Nicole,5,in,office_in,47,2835,7836,5001,0,6764,6764,2835,1072
Nicole,5,in,office_in,48,9654,15135,5481,0,13467,13467,9654,1668
Nicole,5,in,office_in,49,2977,7978,5001,1,7025,7024,2976,953
Nicole,5,in,office_in,50,8836,14553,5717,0,12647,12647,8836,1906
Nicole,5,in,office_in,51,2866,8312,5446,0,6406,6406,2866,1906
Nicole,5,in,office_in,52,3455,10121,6666,0,7738,7738,3455,2383
Nicole,5,in,office_in,53,2978,8455,5477,0,7025,7025,2978,1430
Nicole,5,in,office_in,54,8699,13797,5098,0,13081,13081,8699,716
Nicole,5,in,office_in,55,2865,8312,5447,1,7114,7113,2864,1198
Nicole,5,in,office_in,56,9289,14172,4883,0,13219,13219,9289,953
Nicole,5,in,office_in,57,9290,15480,6190,0,13455,13455,9290,2025
Nicole,5,in,office_in,58,9530,15245,5715,0,13339,13339,9530,1906
Nicole,5,in,office_in,61,10435,15673,5238,1,14482,14481,10434,1191
Nicole,5,in,office_in,63,2861,8335,5474,0,6430,6430,2861,1905
Nicole,5,in,office_in,64,2971,8447,5476,0,6661,6661,2971,1786
Nicole,5,in,office_in,65,9284,14490,5206,0,13056,13056,9284,1434
Nicole,5,in,office_in,66,2354,6464,4110,0,5750,5750,2354,714
Nicole,5,in,office_in,67,8913,13534,4621,0,12580,12580,8913,954
Nicole,5,in,office_in,68,10130,14892,4762,0,13462,13462,10130,1430
Nicole,5,in,office_in,69,2863,8103,5240,0,6554,6554,2863,1549
Nicole,5,in,office_in,70,9422,14423,5001,0,13114,13114,9422,1309
Nicole,5,in,office_in,71,8538,13298,4760,0,11989,11989,8538,1309
Nicole,5,in,office_in,72,8872,13978,5106,0,12671,12671,8872,1307
Nicole,5,in,office_in,73,8706,13946,5240,0,12278,12278,8706,1668
Nicole,5,in,office_in,74,8462,13222,4760,0,12032,12032,8462,1190
Trevor,5,in,office_in,4,9686,14553,4867,1,13007,13006,9685,1546
Trevor,5,in,office_in,5,10310,16030,5720,0,14123,14123,10310,1907
Trevor,5,in,office_in,6,2878,7883,5005,0,6213,6213,2878,1670
Trevor,5,in,office_in,7,10250,15731,5481,0,13466,13466,10250,2265
Trevor,5,in,office_in,1,9898,15144,5246,0,13951,13951,9898,1193
Trevor,5,in,office_in,3,1909,7151,5242,0,5126,5126,1909,2025
Trevor,5,in,office_in,4,2862,7792,4930,0,6363,6363,2862,1429
Trevor,5,in,office_in,5,8870,14113,5243,1,12086,12085,8869,2027
Trevor,5,in,office_in,6,7989,11797,3808,0,11074,11074,7989,723
Trevor,5,in,office_in,7,9147,13766,4619,0,12096,12096,9147,1670
Trevor,5,in,office_in,10,8735,13667,4932,1,12025,12024,8734,1642
Trevor,5,in,office_in,13,2690,6978,4288,0,6023,6023,2690,955
Trevor,5,in,office_in,14,2741,8703,5962,0,7271,7271,2741,1432
Trevor,5,in,office_in,15,8834,13602,4768,0,12052,12052,8834,1550
Trevor,5,in,office_in,16,7747,11797,4050,0,10725,10725,7747,1072
Trevor,5,in,office_in,17,10964,17396,6432,0,14656,14656,10964,2740
Trevor,5,in,office_in,18,11562,17008,5446,0,16091,16091,11562,917
Trevor,5,in,office_in,19,9178,15137,5959,0,13229,13229,9178,1908
Trevor,5,in,office_in,20,11095,16469,5374,1,14315,14314,11094,2154
Trevor,5,in,office_in,22,9621,14627,5006,0,12958,12958,9621,1669
Trevor,5,in,office_in,23,8703,14185,5482,0,12396,12396,8703,1789
Trevor,5,in,office_in,24,10035,16949,6914,0,13729,13729,10035,3220
Trevor,5,in,office_in,25,10133,15344,5211,0,13429,13429,10133,1915
Trevor,5,in,office_in,26,3454,8698,5244,0,7267,7267,3454,1431
Trevor,5,in,office_in,31,6524,9858,3334,0,8904,8904,6524,954
Trevor,5,in,office_in,33,7236,11954,4718,0,10763,10763,7236,1191
Trevor,5,in,office_in,35,7477,11935,4458,0,10770,10770,7477,1165
Trevor,5,in,office_in,37,6447,10910,4463,1,9362,9361,6446,1548
Trevor,5,in,office_in,39,6520,11286,4766,0,9618,9618,6520,1668
Nicole,5,out,office_out,76,1,4285,4284,0,5832,5832,1,1547
Nicole,5,out,office_out,77,1,5688,5687,0,8146,8146,1,2458
Nicole,5,out,office_out,78,1,5020,5019,1,5852,5851,0,832
Nicole,5,out,office_out,79,1,5132,5131,0,5784,5784,1,652
Nicole,5,out,office_out,80,1,4185,4184,0,5378,5378,1,1193
Nicole,5,out,office_out,81,1,4287,4286,0,5239,5239,1,952
Nicole,5,out,office_out,84,1,4172,4171,0,5125,5125,1,953
Nicole,5,out,office_out,85,1,5126,5125,0,6762,6762,1,1636
Nicole,5,out,office_out,86,1,5202,5201,0,6394,6394,1,1192
Nicole,5,out,office_out,87,1,4042,4041,1,4758,4757,0,716
Nicole,5,out,office_out,88,1,5000,4999,0,5712,5712,1,712
Nicole,5,out,office_out,89,1,4623,4622,0,5302,5302,1,679
Nicole,5,out,office_out,90,1,2000,1999,0,10458,10458,1,8458
Nicole,5,out,office_out,91,1,8514,8513,0,9587,9587,1,1073
Nicole,5,out,office_out,92,1,4309,4308,0,5978,5978,1,1669
Nicole,5,out,office_out,93,1,8715,8714,0,9429,9429,1,714
Nicole,5,out,office_out,94,1,8242,8241,0,8958,8958,1,716
Nicole,5,out,office_out,95,1,5000,4999,0,5648,5648,1,648
Nicole,5,out,office_out,96,1,4289,4288,0,5343,5343,1,1054
Nicole,5,out,office_out,97,1,4585,4584,0,5298,5298,1,713
Nicole,5,out,office_out,98,1,8549,8548,0,9499,9499,1,950
Nicole,5,out,office_out,99,1,4762,4761,0,5476,5476,1,714
Nicole,5,out,office_out,100,1,4216,4215,0,5506,5506,1,1290
Nicole,5,out,office_out,102,1,5174,5173,0,5853,5853,1,679
Nicole,5,out,office_out,103,1,4765,4764,0,5712,5712,1,947
Nicole,5,out,office_out,104,1,4290,4289,0,5243,5243,1,953
Nicole,5,out,office_out,105,1,4142,4141,0,5090,5090,1,948
Nicole,5,out,office_out,106,1,4008,4007,0,4959,4959,1,951
Trevor,5,out,office_out,1,1,5232,5231,0,7660,7660,1,2428
Trevor,5,out,office_out,2,1,5448,5447,1,6281,6280,0,833
Trevor,5,out,office_out,3,1,5853,5852,0,8477,8477,1,2624
Trevor,5,out,office_out,4,1,5850,5849,1,8516,8515,0,2666
Trevor,5,out,office_out,5,1,5483,5482,0,7972,7972,1,2489
Trevor,5,out,office_out,6,1,8213,8212,1,9708,9707,0,1495
Trevor,5,out,office_out,7,1,7391,7390,0,8582,8582,1,1191
Trevor,5,out,office_out,8,1,6429,6428,1,9529,9528,0,3100
Trevor,5,out,office_out,9,1,6195,6194,0,8580,8580,1,2385
Trevor,5,out,office_out,10,1,5738,5737,1,8955,8954,0,3217
Trevor,5,out,office_out,11,1,3818,3817,0,7633,7633,1,3815
Trevor,5,out,office_out,12,1,5298,5297,0,7445,7445,1,2147
Trevor,5,out,office_out,13,1,5503,5502,0,8125,8125,1,2622
Trevor,5,out,office_out,14,1,4857,4856,0,7177,7177,1,2320
Trevor,5,out,office_out,15,1,5862,5861,0,8245,8245,1,2383
Trevor,5,out,office_out,16,1,4531,4530,1,7125,7124,0,2594
Trevor,5,out,office_out,18,1,6060,6059,0,8306,8306,1,2246
Trevor,5,out,office_out,19,1,5005,5004,1,7624,7623,0,2619
Trevor,5,out,office_out,20,1,5276,5275,0,7382,7382,1,2106
Trevor,5,out,office_out,21,1,5107,5106,0,7180,7180,1,2073
Trevor,5,out,office_out,22,0,14072,14072,1,17107,17106,1,3035
Trevor,5,out,office_out,23,1,5686,5685,0,8310,8310,1,2624
Trevor,5,out,office_out,24,1,5647,5646,0,6363,6363,1,716
Trevor,5,out,office_out,25,1,5038,5037,0,7566,7566,1,2528
Trevor,5,out,office_out,26,0,6678,6678,1,9977,9976,1,3299
Trevor,5,out,office_out,27,1,5604,5603,0,6662,6662,1,1058
Trevor,5,out,office_out,28,1,4628,4627,0,7251,7251,1,2623
Trevor,5,out,office_out,30,1,4888,4887,0,7246,7246,1,2358
Trevor,5,out,office_out,32,1,4722,4721,0,7517,7517,1,2795
Trevor,5,out,office_out,34,1,5006,5005,0,7748,7748,1,2742
Trevor,5,out,office_out,36,1,6198,6197,0,9415,9415,1,3217
Trevor,5,out,office_out,38,1,5498,5497,0,7892,7892,1,2394
Nicole,1,passby,passby_out,15,-1,-1,0,0,3261,3261,1,3262
Nicole,1,passby,passby_out,16,-1,-1,0,0,2832,2832,1,2833
Nicole,1,passby,passby_out,18,-1,-1,0,0,3180,3180,1,3181
Nicole,1,passby,passby_out,19,-1,-1,0,0,3300,3300,1,3301
Nicole,1,passby,passby_out,20,1,3536,3535,0,6300,6300,1,2764
Nicole,1,passby,passby_out,21,-1,-1,0,0,2921,2921,1,2922
Nicole,1,passby,passby_out,23,-1,-1,0,0,2693,2693,1,2694